---||----E-----B----E-----------------------E------E-------o------------|--B---M----M----------T-o-B-B---|------M--E---------------|---------|-B--------------o---E---------------XT-----|--T---o-------
----------T------------X-------|-------M------M--|T---------X--T-T--T--o-----oT--B--?-?-XM?----T?---o----|-M--B-----B------------o---o?--------------------------------|---------T----------------------
----?T-------?------------E?---?--X----E---|X--o------T--|---?---------------X-M------------T---?--B----------X--o-----X-----------------B?--T--XM-B--o------E-?-B--o----------------B-------M-?---?----
--E----?-|-|-----------?B-B-----E------E-?---B--------X----|--X--------------E-E--MM--E-----M----------TM--X-XM---------------M|---------M----------------X-----M-----------|--------?BE-------------|--
--|----------MX-----X--------o-----------T----BT----------------?------o|---|-E-----?----------?------------------X--o----?-------Mo-XB----?-----X--------M--------?-------------------E----|E--Bo------
----X--------------|---XT------------|o------T|----------E----------------|---T---|-------M--E---------------B-o------E------X-o-B-?E---B--E-----E-----X--?B--X-|-|X-----E-T--------|----------X--MT----
---M------B------X-------Mo---|B------------E-M-?-o--------------o-?M------o-o------MBo--E-|---B----------------E-----------------|-----------M-----B--------oE--T-o-------E--------MT-|--|-------------
-----T-B------E----------X--X|---------M----------M-------T-----B-?B--B|E----B-?-----T----|---M-E------o------?---|-------XB----------o--------E-M-|X------------T-T---E----X----T-E--B--------------M-v
----ET------T?X--------------To-M--?-----TM-----o------------------M---T---------------|---Mo-?E--E------------M-------|-E-------X--------------B-------------M--E---E------MM|----------MEX-----------f
-oE--X-T-----|--X---------T----X------M--?-X---------------M--------B------E?----o------E----X--MX------o-----X--B-o--o---------T--o----BMTB-?-?-E--E----------EE-----------------o-----BB------oT-B---f
-|-|----------------E?T-?------------X-------B--E|-------B------M-----------------?M-------------o---o?---T--------------------------Mo---X-ET--o---T----------B-----------------oT-T-o------T---------f
----------E---|-M|---X-------M----B-------------------TT-------------|---B------------------|---------T-----T--------------E-----------------------------------------------------X-oM---M------M------Tf
----E----------ToX?-----M----E--------X-----------o-?--T--X-X-X---------B-------T----?-----M--?-|-------M----------M-T-----------M-?---B-------T--------To--------------o-T--E----B----------------o--Bf
-----B-----X---------------------T----E--E----|----------------o--EX--T--------o--M------B-------T|-----E------------X---------------------?--T---o---E--B--T------------|Xo----------o-----?----------f
m---M----E------------?------------------T--------------o---?-?----B----T----E----?----M-----?-B-----------------|--E----X-----M--------MX---T-----E--------|----------------|----E-----------E-M--B---X
XXXMX|-XXTXXXXBMXXX?XXXXXMXXXXXXXXXXXXXXXXXEXXXXXXXoXXXXXXX|XXBXXXX?XXXXXXXXXXXXXXXXXXXXXXXXXXEXX-XXX?XXXXXXXXXXXXBXXXEXXXX-X-XXXXXBXXXXXXE?XX|XXEXXXXTXXXXXXXXXXXXXXXXXX-XXBBXXXXXXXXMXXTXXBXXX-XEXX-XX
