----o----B---X-T--X-----o------o-----T-?X-TT-----|||-----------------?-------------------T-----oXE-------?-?o------------B--|------|---B--B-----Boo-ToM--------?E-----|-X-------E--T--------X-B-|-----|-
---------|T-|-----------------M---T------X---------MM-----o--B-BB-o-E--M------X------------------T------|-----?---------------|-----?XT------------E---X--------o----|---------o----------|-T-----?-----
---oM----?X--|-|-----?--------XMX------|----|--XT----M----B---Mo----------M---X--M-M----B------B--------?----|--------?-|-------|-------X-E-------------E----------X--E----M--E-----E----------|-----B--
--o----------------------M-M---------------M----?--X---|--?-----o--------------------------------------|---B-M??----------o-------B---?--------X----------T--|B----B--o---B---------------------|B--T---
--o---X--T-----o-oXT-|-------B---B-----ET-------------------B--B-B------------T-----B--E-------o-----------------E-E----------B----B--B?------------M?--X-B-----------M----E--------?-------E--------B--
-M--------------|-?---------------|T------E-E-----------------X---------|--------?-------|---?----T----------X-----------------------------------M--------M--------------------T-?|----------o|--M------
-|?T-----T-M-?B------------|-----Bo------E-?------X----M----------T--------------------X---------o|-|E--------XEE---oX------------------------o-----------------E--------------------B----B?------------
--E|o?-X---?----?-M-----o--T-----T-|-------T--------M--||X-B-----XE----o-E?----BT|--------X---------E-------Eo---T----------------|------E-----E-?---?-----X------XT|------?-X---B----T--------X-T-TX-ov
--?-?-----------B----------MB--B-----o?-------o---------T-------------E-----------------X---o-------------B----?---BT---E---T----|----------X|-B--B|------------|-|-B-----B-M-|-------|----E-----------f
------o-------B-------E-----?------X---XB--------?---X-T-?---E------------E---------?-E-X---------X-----------o---------To---|-?E----------o--------M--|---E--?---o----E--T---X-------B--------M------Tf
-B----------------T|-M-o-----------M--o-----|-T-----------X----------------------XM---T--?---E---------X-----B---?X-----?-XT---B---|------|E---------M-----T-?---T-M-B-------M-------------------EXT---f
------oB-------M-B-----XM-------E-----|-----|-M------X|----------E-------T--------o------X---E----E-----T----E----B----B-----------T--------E------------|----B-M-----T----------o-------?-----B--|o---f
---|---E-----------X-B--|--------B---X--|T-----o---------?---?--?----|--B----ME-------?----XM--------X----B-----T------TT----------T---o-o-------|------------------E-------?--?----------ET----------|f
-------------|---------o-E-----T--o--------------------|-M-----?--|-M---------X------T---B--|--------E----------|-----------M----||------------B---------------|----------------o----------o--E-|------f
m--------|o---X------?B------|----------|------E-----------T------?-----------M----B----?--MX--------------B---|---------?---E----o--M--|---o--------BE-----------E--MXE--------------------?-X--------X
XXXXTXXXBXXXXXXMXXXXXXXXMXXXX?X|BXXXXXX|XXXXBXXXXXXXXXoXMXXXXMXXXXXXXXXXXXXXXX|oXXXXXX|XoXXXXXXXXXXXTXXXX?XXXXXXX?XBXXXBX|XXXXXXX?XXXXX|XXXXTXXXXXXXoMXXXXXXXXXXXXXXXXoTXXXXXXT|XXXXXEXXTXXXBXXX-XXXMXXX
