---?-------ToEoT---oM-|---M------?--o-----------B-----X-------------?--X----?B-------------T-T-oT------T---------oMB?-??---X-oo----T------|-B---------------B-----------??M---------------T--X-----B--|-
-B--|---?-----X-------------T--------------X?--B--?--------|---T------------M--------M--BT-----Bo--EE----B?---E---?-------E------------M---B|------------------T----------------?--oX------B-------T--X-
-T---------?------------BM-----------------------B-----------------o---BT---|---?-------------------EX----------------------o-TT-o-------------E----|---------M--X----E-o----|---?------------|---EXT---
----------B----------T------------------E-------------B---|----------------EB-MB----o-------?--?--------------?--------T----?------X----M-T------------B--T--?|-----------X-------BE------------T-------
----------|--------------|------X-----M---o-------------------|-------E--------------------X-X---o------o-o----B--------M-B-----T------------E-----------------X------B------B-----|----o--------B------
-B------------------o-------------M----T---------o-E---XB--B------?B-?----------?---o-------|---T---------E---------M-?B-B-|-------?-----------?---------------X----X-X----------------T--o?-T--X-------
------T-------------B-?------------B----B?----M-------?T---o--X------oT--M--X---|-X------?-T---------------?T----------?---o?--E---o----T----TTE|B-?-----------B--B--------o-----|B----X-Bo-------------
-T-----------oT--E-----X----oX?---------T---------B---------M----MX---E--------o-----------BX-----o----------------?----o-B--X------X-----------------B-E---------|--o----X-------|---------o--E-------v
-|X-XM--M-M-----TX-T----M|-------B---------T--M----X?---------Xo-E------------?----E-T---|-B------B--|----X-----------?-----X?------------------?-T------o-------------T--T---o-?-----B-----E-----?--TMf
------T-X----TB------------E----?---M-XT--X------X-BX-------T|-----------------------|-E----------M----?--o--------M--------Eo-B----o-T-----------------------M-T-oE----------X-|E------------B----|-|-f
-------E-T-----TTE-----||-|---X--o---------?-M-----X---------|B-------------oM--o----X--B-----B-------M----?--?----------------|-X-X------MM------?-T---|B---E-T|E-------oE---o-----------B-|o--------Xf
-?-M----?o---T----?|E|---Mo--?--------------E------T-?---E---X--B|-T----|-|--M|--M----o---M----------------------o---o--------?-----B--|-X---E-?-B--|B-XM-------------?-o------T----------?----M-MM-T-?f
---------------B|X--E------B------------M--|-Eo--------BT-----B----E------B----TB----XT----B-------------------B|---T---EB-B-o-------E--|-BT-----|-------------B-?---------T------X-E------------------f
-M-----B----X-------X----------------B---------E--o-----------o-B---B---T-M-------------X---------??------E--MX-----?--o-T---M--T-------------------------M-|------BB------------------------X-M-------f
m--?----T-E------------------X-o--------B------M-M----------?-----o--E----------------?-------o-----------------------M-----|-----E?---------|------X---o-------------|-------B----X------B---T--B-E---X
XXEXXTXXXEXXoXXXXXXXXXXXXBXXXXXXXXXX|XXXX|XX|XXXEXBXXXXXoXXEXBXoXXXBXXX?XoX-XXXXXE?XXTXBXTXMXXXEXXXoXTXXXXXXXXXXXXXXXTXXXEXMXXXX-XXXXXXXXXXXXBoXXXXXXBXXXXXXXTXXXoXXXXXXXXXXXXXXXXXXXXXXXXXX-XXTXXXXXX|X
