--------------?------B-?---|--|-?-?-?-------------------------M--------T--------|------X-|X-B------M------------------X--------------T---E-?T-BE------?--X-?---?-B--E-X-?-----?-XoM-----M-------T-------
----o--?B----Eo-X-|--T----|--?-----B--o-----------|-----------------E-B----------o------------T-----E-----------X------|---XE---E-----------|M-----------BE-------------M---|-?-------TE----X---B----X--
-----------M----o--T-B------|-------?----------B--|-------|-BBT---------X?-----------To---------------?-----o---------|--o------X--o----E-------------------?----B-------?---o------------?--------|----
-----------------oM--o--------?-----------------M-?---------------X--X--|-M|-T-------------------M-------T--oB---?---?E-X------?-----o---------X-TB--E-------------oX--------X-----T-------------M------
----------E----M--------------------o---|?-------T-----o-----EoX-------?XT-------BE-X--XM-T-----M---?---oM----------B----X-----------------|E---M--------------------B-----------|--o------X----B--T----
----E-----o-------T-EM---|----------|E-----------?------|?--X-------B-B--M-----------------B--------E-------T-----------------B----T--------------------B---M-----B?-E---?M--o----T-----------T---------
--B--------B----------------|------|---X--------MT-----T--------o----------T--------?---------M------E-------X-----o-E-------------------------B?------o----B--------?----------?-----BB-TB----B-M------
-----------X--X---?--------E--?M--XT-----------E---------------T-------------T-E----------B--------M----B----T-------o-E-------T-----o------------------------E------?--------|--------E-X----E--T----|v
----------BB----------T-|-T---o--------X?--T-----M---------M-----M------E-----------T--X-TM-----------B-----------E----|-----o----?X-----M---M-------T-----o------?--EB----M-oTT-B--------?-----T------f
---------------------o-----------|--X--o-------------?-------------------------?------B?-?------|--B---T-E----------------?------E------|---------M----B----E------------|-------X-|--T--------------T-f
--BM--o---------?--------T-|-|--M-----T---oX-------T-----------T--------M?E--------------|---------o------X---E--T---E------B-------------E---E-|--B--------?-o-------X--------T-B----X----o---o-------f
--M-----------T----------------------M--------------------------------------o-|-|------X-T?---o---X----?---?---E-?--?o-E---------------------M----M--T-----E-X----------B--M--X?---T-E----EBXT|-----o--f
-----|------X-----B-T-------BX---B-------B---|-------o-------------------------o--M---MM-T----BT-|------o-----------o--?-------?------oB-|---------X-E----B---------------------------?-----EoMX---oX--f
--o----------E---?o-?-X--B---T-----ET------|-----X--------------o----?---------E---X----?--X--------------|-|--XE----?-B---X-------?o-E------------T-----------B----------------------------M----------f
m-------------E--------B--Xo--------------E--X-|-Mo--oTo----------T-T----X----o-------E-----------TX---E--------------E--?--M-----X--------|--EXTXB--BBM------?----------X------E-|-------------B------X
XXXXXXXXXXXXX|XMXM?XXXXXXXXXXX|XXXXXXXXXXXXXXXXXXXXoXXXXBX|XXXXXXX?XXXX?XX|XXXXXXXXXXXXXXXXTXXXX-XXXXXXXXXXXXBXXXXX?XBXXXXXX?XX|XXXXXXXX-XXXoXXXXXXXXXXXXXTXXXXXMXXXXXXXXXXXXXXXXXXXXXXXXXE?-|X|XTXXXXXX
