--B------------E-----|----------------?-?------------------------o-B-----------------B--o----------|-------|----M---------------|-----|-X-B----------M----------------|--------?------------------------
----------X-|---------M-------E-------M-------------------|--------------------------------E----------------------------?-T-----------------------------o-X------------|----T---------------------------
------------------T-------B----------------|---o-------------------T--X---------------------?--------------------B---------------o-------T--------------------------------------------------E---E-o-----
-----|---------|o-------------------?----?---|-----------------------------------o--?------?-----M------------X----------EE-------M-------T-o---------E---------------|------X--------------------------
-------B---o-----B-------------------TBM--------|-------------------------------E-----------T-----------------------T-------------X-?M----------------------------------------------o----o-------X------
---X-E-----------------------------?--M-----X-----?X-----------o----------------B-o---B--------M-o---------------------------?------E--------------------M-----------------------B-----B---|--------o---
-----------o-----------E|--------------|------------|--?-------?-------M-?---------------|--|-X------------|-------------------EE----------------------?------|----------X--------o--------T---------?o-
-|-o--------oM---------|----------------|------------------------------------------------------------------o---------M-----TT-----M-----?-----------------------------------------------?--B-----------v
----X-----------------------------------|X--------------------M------------------------o-------o--?E--M------------------o--------|------------B-------------------T-----------M-----------------------f
-------E-B----------X----------------------------------------E-B--------------------------------?--------B---------------------T-----------------T------------o----------------------------------B---B-f
-----------------?-------B------------------B-------------TM-------|-E---------------------------o-----|---M-----------------------?---------------------------------E------X--X-----------------------f
---------X-|--------------o------------o------------------------E---------------T-------------?---|----------M-------------------E--E----------------------o--------M------|-----------?---E-----------f
--------------?---------------------------E---------------B-------------------X-|-------B----------?-|-----------------------M-------oX----------M---X---------------------------------M---------------f
----BB------------E---oE---B------T----E----T----------|EM--------------------M-?------------o-------------------B---X------------------------------------T--o------------------T--T-----B----------BE-f
m---|------E-------------o----------------------------|---B-------------o------------E------X--------T--------|--MB------B---X----------------o-----------------TT-------------------X--M--------------X
XXXoXXXXXXXXXXXXXXXXXXMXXXXXXXXXXXBXXXXXXXXXXXXXXXXXXXXMXXXXXXXXXXXXXXXXXXXXXXXXXXXXXXXXXXXXXXXXXXXXXXXBXXXXXXXXXXX-?XXXXXXXXXXXXXXXX-XXXXXXXXXXXXXXXXXXXXXXXXXXXXXXXXXXXXXXXXXXXXXXEXXXXXXXXXXXX|XXXXXX
