---------B---T--------oX---------?-----------|---------|--Xo----X-?-------o--?-----------B-----B-----B---|------M--------------|---|---------|-B--------------o---E-----T----------------|------o-------
---|-------?M---X--M|-------?---------E------M-M--?----o--------o--TMo-ToEEB-----B-T--------X-E-TX--o----|----------B--------MT-ToX--o?---------------E----------------|------X--|-T---------B?---M-----
----T----------------|----M---oM---?--M---E-----o---------M------Bo---T--------------?--E--B-M--|--------M--?----o---------X-------------BTM-T--XM-B--o------B-M-B--o-------------|--B--X-----X?---T----
-----------------------------?---E----o-o-|-----T----M-|------------------MX-----T-----o--?--M--EX------o----MM--------M-------|------X-------------------?-----M-o------B--|------B--BE------B------|--
-------------M-|-B--?--------?----E------------------X--------------------M------M---------------E-?M-----M|----M-X-----B-?--o---X---X----?------X--E---------?------------------X-X----EX?--E--Bo------
--TX-T-T|--------------T---B---|-B-X?-T---X-----?---------o---|----M------E-------E----------------X------------------E------X-----?----B--E----ME----------------|X---?-E-T--------X--B-------E--M-----
--??---|-----?----|------E-----------|--|-?---o--------------M?--T-----------o--|--------T-?-M----------o--E----E-------|---------|--T-----------------------o--|--o----------------M--|--|-----M-------
---o--|------X----X---------E----------MT---------------------------T------------TB---------M--o--|--------------------------E-------Mo----------E-|X------------T-T---------o---T-E-----------------M-v
---M-o-X----o--E----------T---------M---E---M-|-E--------E--M---------M-----X|--M-?---X----X-----|M----X---E---B---------?----B---------------------------M---M|------------M---------|----X--T--------f
---X---M----------E---|----X--------TX-------T--------------TB--?----o---X-------------------X--M-|---E-o-----X--o-B--o----T----T--o-----MT----|M---E----------EEM---M---E------------X-TB-T----o------f
----------E----o------T----o-?-----Mo--?----X-----------X--o--|--------------X-------|-E--B--B-----------?T--|-----------------------ME|X---E|---o---B----------B------|-----TB|-oT-T------------------f
------------B---------|-----o---------X--------------------X?----|-----T?------To-B--?|------------M--T----oT--E----------EE-------------M---------|---X-----------------BE---------M-----------------?f
-?--|----TM--B-E----o---?-------X--B-------------?--T-BB--o-oT-----|------?-------------o---------------M-----|-----XTX-----|-M--M-?-----T--T--T--------To------------?-o-T------------------------oT--f
--------M---?-----------?E--|-------o---------------Eo-----M------o--ME--T-------------T--M---------X---------------o------------E------------|-------------T------?--XX--X-----------------?--------T-f
m-----E----------|-----|-----------T--------o----M-------------?--oo------B---------|---------------------M------|-oE----X--------------o-T--T-?-|-----------X------M------o-|----------------E-M------X
XXXXXXTXXXEXXXXXXXXXXX-XX?TXXXXXXXXXXXXXX-XXXXXXX?XXXXX-XXXXM|XXXXXXXXXXEXXXBXXMXX-XXXXXXX||XX?X|oXXX?XXXXX?XXXXXXBEXXXXXXXXE-XXXXXXXXXXXXXXXXXXXXXX|XXXXoXXXXXXXXoTXXXXX-XXXXXXXXXXoXMXXXXXXX|BXXXXX-XX
