?---|--oT----------------E-------------EM-?--?---X-----------?-------XM--------|----E------oB-------ooMoM|-?M-X?BT|XX-||MMB?E|B?|MEB|E|?o|EMoEX|TETTo--?MoBBT?X-E|XEMoB|EE?o-BoTTBoBT||ooX-T--Mo-|??oT?o
------------------To---B--o--o--E-X---M---To----?-----------|-------------E-------------------------oM?|o-EBE-MTo?-BT-MMBE|XTME?|o|TB-TXMMMoB--B?MTo?EXME|ToT?B|T|TXoB-oB-MXMT-MEBoX?BXo|BoEo|ToooXM?BBX
|---E--------B----------T-B---?------?---B-----X-ME?-----X-----?-|----------B-------------------?---To?TX?oTE?-E|MEXXXBEBoo?|EXE-?Boo?|--MBXEXEEMTBMMEBX|EX??-EBMoTTXo|?-Moo?ToTo-|?MX|||BoXX?-oX-ET|MMT
XX-X--E---------------TX------o------------X---------M-MM--?------|-----o-------------E----B--------?-ETMMTMXM|B?EM|o---X|MB-B?TBMEXTo-oB?|o-BooTM??MEXB?-BoB|T|Xo?XE-EoMoM?|MMEB-EMBEEEMoB|TEEE-XT?|MT?
M------X---T----------T---|X-M?E-?--------------E--B----X-------T------M----------E---E----------XT|-X-o?B|X|EXT|X|BBXoBX|MBTXTMo?TTMTB-E?oE?o-oEo-ooXB-ooXXX-E||E|BMoBTEB|M|?E||??MoM-B|MEET?MX|oEM|?XT
XX--XE----T--|-----M-M-------T----o--------------------ToM--|-----Xo----------X----o------?M--------TEEMTMEMX|?T?EM?M-BX?EMTXB|BMMTBETBETBo-ETTMBX|EBEXBoB|?TMo|T?MBEE-M-?E--?TBBM-XB|BBooBB|X-B?MTM-MM|
?------oX-------------|------E---M---T----------T-X--E---------T---o-X----E------------?-E----------MME?ToX?-TX-|EoXTMTMMEEMEE|XBEMB-TBX-BBM-??oE-Mo||EX|?MoTE?|X||XX-B-?B?|TXE--?-EB-BTXE|TB?Bo|E|M|T?T
M-?--E-o--|--o-------------X----|--T---E-----------ToET----------X---o---M-T---------o------E----|---B-BMX|?o|--M-Mo-|o|MM|?BT--X?TBoBXoXEB|EoM??|BTE?-EEB?-?|TMX-MM|?XTX??XBBXoMEMXM|?MMXE?XETMoXo-|?Mv
X--MX--B-------B--------------E-?-----B----TXX-E--------T---?-------o-----T-----------------X-M-----M-BT|--M?M-|o--E|X?oB?T?MXBMo|XB--|MX|?T-oToEoBBBoTETEEooooBE?X|o-?oXT|ToBEEX-MBTToMBo||B--BX-oMXTMB
X--?--|--------------?-------B----o----?E-------|--------o-----B--E-----B------------M----------|o---oo-MEEXT|oMTBE?-MEM|T?TBE|BEE-M?EXBTM?T?-EXTMT?oTXB?BEE-MTo|MXX?BBB-?MMTBMT-EEXoBEMM-BM?|-|E?B-E?TB
-X--X-X------E----------X-o------------T-----------------M------?o---o-----|----------B------------o-X||oB||oMM-BE|XB|XT?XT-XXTET?-?BME?-B|MT||XB--ET-|B--BMMME--o?o|MXMMMB-X?M-EXXXEXT|???BMM||M?MB-B-E
E-----TE----M---------------o-|-MMX----------oT---B--------X--X--o------X-|-------oo---------|-T--M-||o|E??TXo?Eo-B?oTM?-TX?M?EE-X|o|?E?TEMBBTET-TEB?TXE|--|BMT?M-E|--|ToTB??|o-|T?T|-XB|||M|BTTXXBEE-TX
X---M----B?-----M--o------E-----EM------------------E-|--M-----?--------B----|---B--T---------X----?BoEXoTTEMEMTE?|-EXBMMB-?o|-BM-?-T|TX??T?-|XM?TXoET-B|TXo?M?MME?XBEEEM?|B-BXTB?E|M-oBoTBB-|MTX|X||Xoo
E-----------------E-|---------E--------|?---------M-X----X------------E-B?-----TX--X--T--X--X-----T----o?|B?TXB|??|X-TT|Eo-M|X??XMTEM-T|TTXo|XTTXoMM?B-EBX-TBBEMXXoX?-TMMXT|--?o-oMoTT|M??T?EX|EB|M-BEB-
mM---------E-M-T-----------MT----?---|To------T---------B----E-----T-----?--------E------------------o-BXE|M-XXE-XEEBEMBTB?B-|?oMToEoT|E|-TEM-EXT|?-|EMoXXo-?ETT?MoTX|To-X|BXo-E|?BoBo|Eo|TXXMEXTT?BB--E
XXXXXMXXXXXXXTXXMXXXXoXXXXX-TXE|XXoXXXXXXXXXXXXoXXXXXXXXXXXX-XoXX-XXXXXXX?XXXXXXBXXXXXXXXXXXXXXXXXXXXXXXXEXXX-X-XXXXEXXXXXXXXXXoXoEXXTXXXX?XXXXXXXXoXXXXTXXXXTXXXXXXXXXXXXXXXXXXXTXXXXXEXXXXXXXXXX-XXXXX
