----------M-----------------------E----E----EE----?-------------------T------------------------E---Bo-----|--------------------E----|-----?--------?------X-----------M-----E-----M-----------------B---
----------------------------------B---B-X--B---------o----------?---------X-X------M---------------------E----------------------o-------B----X-X----X----------X-------E-----------|--------T---------M-
--------|------T--------------M----------|-------------------------B-------------M----------------------M-------------------------------B----------------------------------M---------|---?--------o-----
--M-----------------------------------------o--------------------o-----------------------------------E------T|--B-------------------------M------o--------------------X---T-?---------------------------
------X----------------------------------?------X--------X----------------M-------|--------------T---------------------------------------E-------?-M----------------------------------X--------?--------
---M-X-------?-E-----|---|--------|---?-T-----------------------------------?------------|---------------E---------BB------------o---------M----E--X--BM----B--E----B----------------------------M---E--
--------------M-E-------------o------------|-----?--------------X----------E----|-----------T-T--B--------------|------------------------------------|--------------|---------B------------T------------
-B------X-M--------?-----------------------o-----------X---T--------------o-----------------------------M-----------------------?------------------|----------B----------M-----------------------------v
-|-----------------------------------------------------------|-X----E-------?---------|-----------?--XM-----------M---?M----------------|----------E-B-------------------------B------BT---------------f
----------------------T--o---o------?-----T----------T----X------------M------M-------------------------------------------?---------o---T----------------MX---M---------------------E--?-------------|-f
-------------------B--E-B-----o------X---------E-----o---------o-|-----------------B------------|----------------------------M--E-----------T----B-------------?----M------------------o--E---E--------f
--?-E----T---?-B-T-----------------------------?-----------------------|---------o---------------B----------------------------B-------------------T-----|---E-------|-?---E------------|E----------?---f
------M---------T-------------E------B--------------?---M--------X------------------------------o-------------|--------?------------T----------M-------?-----------------M----------------------o------f
-----------------|-----------------|--------------------M-------------------X-----------------------------B----------?|--M------------------B-----|----E--M-------------------------?--|---------------f
m--|-----------X-X------------------E----XE-B------|-----------T-----------X----------------------o----------------------------------o-----o-X-----------------E--?----------------Bo---------E-----?--X
XXXXXXXXXXXXXXXXXXXXX|XXXXXXXXX-XXXXX-XXXXXXXXXXXTXXXXXXXXXXXXBXXX|XXXXXXMXXXX?XXTXXXXXXXXXXXXXXXXXXXXXXXXMXXXXXXXXX|XXXXXX-XXXXXXXXXXXXXX|XXXXXXXXEXXXXXXXXTXXXXXoXXXXXXXXXXXXXXMXXXXXXXXXXXXXXXXXXXXXX
