--X---|--------B---XE-----------|-----------------------M--T------E--M--M----T------------------|----------B?-------o-X----E----------T--M----X|------XT--|--B-X-o------------o-------E----o--X------M--
----M---o-----X-?-B--o-B-----------Mo--X--X---M--T--E--Mo---------B-----T---E---o--|B-----T-B-o---T--o------E-----XE-X----------------|-----EX--------B---TX--T-?-E------|-----------X-?---E--------o-E-
--?----------------------o---------X--|------------------------------Mo-----------------X------ETo----|-X-oT----oB----B--------?---------T-------------X-----B--X----E---T------------?E-----------|E---
---EE--------T-----------------------?------------------?M--------E----XB--|------------|-?-----------------T||?----------E--o--M---Eo------------T----------------------B------B-T-------------|----T--
-------X----------------------------o---------o--------E------M-----?----X----o---E----BM----|-------X--o---B---ET---|----?--|----B------|-E---------X---X--------B--o------X----X-----o------B--o--o-B-
----------------------X---------E--E----o-------------------T-----X---oM-------BM------------o---|-?--------------------B-M-------||-?------M------------B--------M------|------------------------------
---B----------||---------------------------------------||------T-M|--|------?-X-------o-------------|--T---E----------T------------------X----?X-TE---M-----------------M------M-------?------E---------
------------|B----M---T------E------X|-----oE-----E---------B-ME---B-?---------B-E-B--------E-------E----o----B----|---M-----------?----------M------o-----E-M-?---------------XB-oT|--B-----o-------?-v
----M----Eo|-E------X----------T-M----|-------XE--M----E---X-M-X-----X--E-M-----------------------X-Eo-X--M-------o----|---o---------------TB----B|----E-X-|------?-----B----------E---o---B---------T-f
---o-o?-M?----M--X-----------B---E------------o------------M--|----M---E-|BM---M--|--------o--XT----?----?-------------T|M---T--MMT-|X----------|-------EB----------------B----------------o--o-oE-----f
-------------o-------T------o-T--M------T----E---B--------|--E---|-M-T?-------T----------E--X------X--T-------------o--------------|-o--------XX--E---------------------X---------|------o------------Xf
------------E-----------------|--|---M-|X--M-----|X---------o?B------T-----M----|-----E-------------|-------------|--|--||-?------X-------E---B-------o-o-----X----X-----------------------M-----------f
--B?--T---?B-|---X----|-|---?------EE----M----------E-----E----T--------T--T--------X-|-X--oM--|-?-B----?--E--X-B---T-T----M-T-X---Mo-----MM----------X---T--|------?--o-----M----------------?-------Xf
-----------T---------X-oEX--|---------E------B---E-----|-------------------------o----X-E------?--M----B------M---XB---------B--M------------|----X-o|----------B----B--?--B---o-X----X-------B-B?-----f
m---E--o------------|---B-----T--------o-o----------?---XX-------E-----E---?-----o--E-T-T-----------|--------?-E--E--B----ME--?--------B---X----T---------------E------M--------T-------o-T------?-----X
XXXMXXXXTMXXXXXXXX?XX-XXXXXXXXXXXXXX|X|XXXMXoXXXXXMBXXXXXXXXXXXXXXXoXXXXMXEXXXXXXXXXXTXX?XX-XXXXTXXXXXXXXXX-?XXXXXX|XXXXXXXXXXXXXXXXXXXXXXXXXXX?EXMXX|XXXXoXXXXXTX-XXXXXX-X|XXXXXXXXEXXXXXTXXXXMXXX|XXXX
