Max fitness:3.0814212671854317------------B-------T---------T-------M---E--M-------E----------X-----------M---B-B--------E----|------E---------------B--------------------------------o---------------E------M-E----T----------E--o---
-----------------------------M------------------------------------------------X----M---------|------------------------B----------------B-----M----B---|--------M-----X--------B-------------------------
------B----?|--------|----T------------TT-T------------o---------------------------?---------------------------------------------------------------------------oo-----------------o-----------B---------
---------------------------------|-----------------------------------------------M---------X---M------T-----------------T----------------XT-B-----------------------------------------------------------
---E--B---|--EoX--T-------BE-----------------------B---BX---------E---------o--BM----------------T----------X---------|-------------------?------------------------------|----------------?--|--?--M----
-------E---------------------?----------------o------------|---------------------?----T------------------------------------------------------------------T---------------B-----------------------?------
-----M-M----------------T-------B------------------------|-----------------------?----E-E-----------o------o------------------?-----------------------?------------B------X--B--|-----------------------
-|-------------------M---B--X----X-------------------------E|-E-----------------B-----------------------------T--------E-----------o----------M-------M--------------M--------------------T----------M-v
---------?---------------------?-----M------?--B--------o--X----------------------------------------------------E-----X---------------E---------?-----------------------------E-----------------oM-----f
------B----------------|----B-------------E|---------M------EB----------o---------?--E|----------|-------T---------E------------------------------o-----BE------|B-BB--------------M-B-----------------f
-----E|-------------------------M----B----?-M--T---------E---------------T--------?-----------------------------X-----------------------------E-----------o-|------M--------E-----------B---M----------f
---------------|------E----------------------------------------------?-------------o--T-----------o------o---------E--------B-M--------------------------------------------T---------------M-----?-----f
--------------|---M-----?-----B-----------------------o----T-------E------X------------------------------------------------------------------------M---------o-------------|-----o--|-o----------------f
----------X|---------o--o-------------?------------?------------X-----------------------E-----------|--------------M?---E?----------o-T----------------------------E-----------M----B-M----------------f
m----|-o----------------------------------------?----------------------------------------|---T---------------------------B-----|----------------------------------?-------EX--------?----?--------M----X
XXXXXXXXXXTXXXXXXXXXXXXXX|XXXXXXXXXXXXXXXX?XXXXXXXXXXXXBXXXXXXXXXXXXXXXXXXoXXXXXXXXXXXXXXXXXXXXXXXXXEXXXoXXXXXXXXXXoXXXXXXXX|XXXXXXX-XXXXXXXXXXXXXXXXXXXXXXXXXXXXXX?XXXXBXXXXXXXXXXXXXXXXXXMXX|XBXXXXXXX
