--------------------------------------------------------------------------------------------------------------------------------------------------------------------------------------------------------
-X-------------------------------B--------------------------E-------------------------o-----M--------------------B--------------E-M-------------------------B------------o------X-----------------------
---------M--------------M-----------o------------------------------B--M------------------------------------------M------------o-------------------------------------B-----------------------------------
--?-------------------------------M-------------X--------------------------------------------------------------------------------------------X--------------------------------------?--------X----------
---------E----o-----------------------------------------------M------------------------------------o--------------------o-----------------M----------------o----B-------------------o-------------------
----------------o-------------o--------------------------------------------------M----------E--------------------------------------------------------------------------------------------------------M--
------------?----B-----M-----------------------M-------------M--------------------------------------X------------------------------X------------------B-------------------------------------------------
----------------------------------------------------------------------------------------------------------------------------X-----------------------------------------------?--------------------------v
-------------E----------------------------M----------------------------o-----------------X------?----o-------------------------------------------M-----------------------------------------------------f
---------B------------?-------o--------BB---B-?-----------------------------o-?-------o-----------------------B--?--------------B---------------------------------------B--------------?-------X-------f
---?------------------------B----------B-------o-------------------------------------------M-----------B--------------------------------------------------?----B---------------------------------------f
------------B------B--------T------------X-----B--M----------------------X------?B-M--------------T-----o------------o---------o------M-------------T---------------------------?--------------------M-f
-----------B---------------T|---------------------------------o--------------------B--------o-----|-------------------------------------B-----------|--------------X--------------------------------B--f
---------------------------||--------------------------------------------T------------------------|-------------------------?-----------------------|-E----------------M-------------------------------f
m--------o-------------E---||-------M-T----------------------M---------E-|------------------------|T----------------T-------------------?-----------|--------------------------o----o----------E-------X
XXXXXXXXXXXXXXXXXXXXXXXXXXXXXXXXXXXXXXXXXXXXXXXXXXXXXXXXXXXXXXXXXXXXXXXXXXXXXXXXXXXXXXXXXXXXXXXXXXXXXXXXXXXXXXXXXXXXXXXXXXXXXXXXXXXXXXXXXXXXXXXXXXXXXXXXXXXXXXXXXXXXXXXXXXXXXXXXXXXXXXXXXXXXXXXXXXXXXXXX
