--------------------------------------------------------------------------------------------------------------------------------------------------------------------------------------------------------
----o---------------------------------------------------------------------------o---------------------------------------------------------------------------------E-------------------------------------
------------------------------------------------------------------------------------------------------M-----M--------?----------------------?-----------------------------------------------------------
-----------------------------E------------------------------------------------------------------------------------------------------------o-----------------------------------------------------------X-
-------------------------------------------------------------------------B--?----------BX-X----------------------------o-----E----------------------------------------------B---------------------------
--------------------------------------B----------------------------------------X---------------------------X------------------MB------------------------------------------------------------------------
--------B--------------E-------------------------------------------------------------------------------------------------------------------?------------------------------------------------------------
----------------------------------------------------------------------------------------?--------------------------------------------------------------------------------------------------------------v
--------B--------------------------------------------------------------------------------------------------------------------------M-------------------E-----------------------------------------------f
-----E--------------------------------X----------------------------------------------------------------------------------------------------------------------------------------------------------------f
----------------------------------------------------------?----------------------------------------------------M---------------------------------------------------------------------------------------f
---?--------------------------------------------------X-------------------------------------------------------------------------------------------------?-T------------------?------E----------X-------f
-------------------------------------X---------------------------B----------------------------------------------------------------------------------------|--------------------------------------------f
----------------------------------------------------------------------------------------------------------------------------------------------------------|-----------------------------B--------------f
m------------------B-----------------------------------------------------------------------------------------------------------o--------------------------|--------------------------------------------X
XXXXXXXXXXXXXXXXXXXXXXXXXXXXXXXXXXXXXXXXXXXXXXXXXXXXXXXXXXXXXXXXXXXXXXXXXXXXXXXXXXXXXXXXXXXXXXXXXXXXXXXXXXXXXXXXXXXXXXXXXXXXXXXXXXXXXXXXXXXXXXXXXXXXXXXXXXXXXXXXXXXXXXXXXXXXXXXXXXXXXXXXXXXXXXXXXXXXXXXX
