Max fitness:3.1360342172945734---------M--------------|--MT------------M---------M---E---o-?M--------------------------------o-E-----------------------X-o-B|------------T------E--T------M--|--------------------------------o-------
-T----------------T-----X--------------------------------E---?-------------------------o----?|----BX---------X-------------T---E-------M------B--E----------M---M--------?-----------------o--|---|-----
-----------------------T---------------------------------------------------M------------M-X---------|---E------------------------------o----------------------------------------|-------------------M---
---------------------------?----------------|-------------------o?-------------------------------------------E------B------------------?---------------o---------------E---------------------M----------
--|-----------E--------M---?--|-------B---?-----------------------------------------------------X-----M-M----EM--------------------------------|---------------------|-----------------------------X----
----M---------------?-------------?-------------|----------------------------------------T-------------TE---------------------------M-----B-----------B-------------T----X------------------------------
-----o------X-----------X----M----------------------|X---------------------------T---B-------E----------------B----------------T---------------------------------------------------------B?-------------
------E-o?-------------|M----T----------T----------------B---------?-----------T------------|---M-----------E------------T--------------------------o---------------------------------?---B-M---------?v
---------?-----B-----------------------------TB---------------------o------------|--|------E------|-------------------E---o-----X------o---|?------------B------|---o--Mo--------------------X-M-------f
--------|------E-E----------------------------------------o---------------o-------E---------------o-------------------B-----X----B-E-----------------------|-----T---------M------E?-------------------f
------------T---------------------------B-B------------------------EX-----------------M-ET-------------------X---E----------------------------oT----?-------------|----|--------------------M----------f
-----------------------?-|---T------------?-----------------M------------X---M----------?-----------------?---------------B------------------------|-----------------T------------B---X----------------f
------------------------------B---------B----oE------------M---?-|-B------o-------------------------------------B-----------|---X-|----------------?-----E--------------------B-B----------------------f
--------------------------------------------------------------------------E------------M---?--------M-------E-----ET------?---o-----------T--------|?-----T----o----B-----T---BX------------E-----X-o--f
m--------?-----------E-?--|-----o----M-----------------------------------------o-----------------------M----------T------------------------------------------------?---o--?--------Mo|--T--------------X
XXXXXXXXXXXXXXXXXXXXXXXXXXoXXXXXXXX?XXXXXXXXXXXXXXXX-XXMXXXXXXXXXXXXXXXXoXX|XX-XXXXXXXXXXXXXXXXXXXXXXXXXXXXXXXXXXXXXXXXXXXXXBXXXXXXXXXEXXXXXXXXXXXXXXX-XXXXXXXXXXXXXXXXXXXXXXEXBXXXXXXXXXoXXTX-XXXXXX?XX
